35 14
16 1 1 1 1 1 1 1 1 1 1 1 1 1 1 1 1 16 16 1 1 1 1 1 1 1 1 1 1 1 1 1 1 1 1
16 1 1 1 1 1 1 1 1 1 1 1 1 1 1 1 1 16 16 1 1 1 1 1 1 1 1 1 1 1 1 1 1 1 1
16 1 3 1 1 1 1 1 1 1 1 1 1 1 1 1 1 16 16 1 8 8 8 1 1 1 1 1 1 1 1 1 1 1 1
16 1 1 1 1 1 5 6 1 1 1 1 1 1 1 1 1 16 16 8 8 8 8 8 1 1 1 1 1 1 1 1 1 1 1
16 1 1 1 1 7 1 1 1 1 1 1 1 1 1 1 1 16 16 8 8 8 8 8 1 1 1 1 1 1 1 1 1 1 1
16 1 1 1 5 11 11 11 11 6 1 1 1 1 1 1 1 16 16 1 1 7 1 1 1 1 1 1 1 1 1 1 1 1 1
16 1 1 1 1 1 1 1 1 1 1 1 1 5 11 6 1 16 16 1 1 12 1 1 1 1 1 1 1 1 1 1 1 1 1
16 1 1 1 1 1 1 1 1 1 1 1 1 1 1 1 1 16 16 1 1 13 1 1 1 1 1 1 1 1 1 1 1 1 1
16 1 5 11 6 1 1 1 1 5 11 6 1 1 1 1 1 16 16 1 1 7 1 1 1 1 1 1 1 1 1 1 1 1 1
16 1 1 1 1 1 5 6 1 1 1 1 1 1 1 1 1 16 16 1 1 7 1 1 1 1 1 1 1 1 1 1 1 1 1
16 1 1 1 1 1 1 1 1 1 1 1 1 1 19 20 16 16 16 1 1 1 0 0 18 1 1 1 1 1 1 1 1 1 1
16 0 0 0 0 0 0 0 0 0 0 0 0 0 0 0 0 0 0 0 0 0 0 21 0 0 0 14 14 14 14 0 0 0 0
16 1 1 1 1 1 1 1 1 1 1 1 1 1 1 1 1 1 1 1 1 1 1 1 1 21 16 15 15 15 15 16 2 1 21
-1 1 1 1 1 1 1 1 1 1 1 1 1 1 1 1 1 1 1 1 1 1 1 1 1 1 16 16 16 16 16 16 1 1 1