17 12
1 1 1 1 1 1 1 1 1 1 1 1 1 1 1 1 1
1 1 1 1 1 1 1 1 1 1 1 1 1 1 1 1 1
1 1 1 1 1 1 1 1 1 1 1 1 1 1 1 1 1
1 1 1 1 1 1 1 1 1 1 1 1 1 1 1 1 1
1 1 1 1 1 1 1 1 1 1 1 1 1 1 1 1 1
1 1 1 1 1 1 1 1 1 1 1 1 1 1 1 1 1
1 1 8 8 8 1 1 1 1 1 1 1 8 8 8 1 1
1 8 8 8 8 8 1 1 1 1 1 8 8 8 8 8 1
1 8 8 8 8 8 1 1 1 1 1 8 8 8 8 8 1
1 1 1 7 1 1 1 1 1 1 1 1 1 7 1 1 1
1 1 1 7 1 1 1 5 11 6 1 1 1 7 1 1 1
14 14 14 7 14 14 14 14 14 14 14 14 14 7 14 14 14